%%%%%%%%%
%P      %
%%% %%  %
%.      %
%%%%%%%%%